# First line is comment

0000x000
0r00x0b0
0000x000
0000x000
00000000
00x0y00x
00x0000x
00x0000x
